...^^^.^^.^^.^....^^....^.
..^^.^.^^^^.^^.^^....^.^^.
.^^..@!....^.^^.^^.^.^....
^^.;......^.^^.^^.^.^..^^.
^....;.....^.^^.^^.^..^.^^
^^^..^^^..^....^^.^.^..;..
..^..^....^....^^.^.......
.^^.^^.^.......;...^^..^..
.^...;..^..^^....^.^^.^...
.^.....^^..^..^.^.^^..^.^^
.^.^...^.^.^^...;..^..^..^
..^..^....^.^^...?.......^
.^^..^^.^....^.....^..^.^^
.^......^^.^..^^.^.^^...;.
.^.....^^.^^.^^.^.^^.^^...
.^^..^^.........^....^^...
....;..^^...^.^....^.....^
.^^^^^^^^.^^.^^.^.^^.^^.^^